16
16
BBBBBBBBBBBBBBBB
B              B
B              B
B              B
B              B
B              B
B              B
B      P       B
B              B
B              B
B              B
B              B
B              B
B              B
B              B
BBBBBBBBBBBBBBBB