16
16
BBBBBBBBBBBBBBBB
B      BB      B
B      BB      B
B      BB      B
B      BB      B
B      BB      B
B      BB      B
B      BB      B
B      BB      B
B      BB      B
B      BB      B
B      BB      B
B              B
B      P       B
B              B
BBBBBBBBBBBBBBBB