16
16
BBBBBBBBBBBBBBBB
B      BB      B
B      BB      B
B  E   BB   E  B
B      BB      B
B      BB      B
B      BB      B
B      BB      B
B      BB      B
B      BB      B
B      BB      B
B      BB      B
                
       P        
                
BBBBBBBBBBBBBBBB